*7⁸—

margue'rite = mm. margarita = aud. merigrioz (Grimm
Gramm 111. 380.).

marne = and. mergil = nora. mergill = nna. mergol.

marque = εὀιιι. maroa = ιιιιι marcha = ahu. marka, undo:
marquer‚ marqueter‚ marqueterie‚' marqueteur‚ mar·
quer etc.

marquis = uveam marcha, σου. marquel

marsouin = ana meri-suin = und. meerschwein.

masque = and. musca (ἰωῆς macula) = nhd. maske =
unae: masquer = bal-masqu& etc.

massacrer = ohd. meizan(mactflre) = oens. etiam sem. pop. gem·
matsken (u'nde tonum num metzger) (Diez).

mfit ι e. mast, tome-nomm1smpt.= nun. mast (mulus).

mat, ate = matt.

mat = mna. mat = aaa. matt? (sohah mat = rex mortuus
est). .

mauvais = prov. malvais: aud. malvasi (malus) (Diez).

mazette = gom ung· matz (homo ineptus) (Frisoh).

meniu = hisp. menino = aba minnefm = eous. mignon!

miesange = mm. pop. gom. meeseke = nna. moise (Diez).

mets = gom. mats = auu. maz (cibus, panis) (Wachter).

meurtre = in 103. ouum. usp. murdre = gom. maurthr = ιῑια.
mordar = nm„ mfirder, uado: meurtrien ihre, meurtrir,
meurtrissure.

mignon = and. minne6n = nhd. minnen (amare) uae:
mignard‚ arde, mignardelet‚ mignasdement‚ mignarder,
mignardise3 mignon, mignonnement‚ mignonnet, migno-
n'ette‚ mignoter‚ fnignotement, mignotie‚ mignotise.

minoe = goth. minniza = ψει. minniro (tenuis) == nna.
minder‚ uude: mincer‚ minceur.

mille = ahd- mila = ηιιᾱ, meile.

mite = aba. miza (culex) = ahd- myte. (cona Grimm

· 111.365).

moisi = mm muffa = mm muff, muffen (mucor).

 

