...gp-

rana erig. (claudicans) = goti. vraiqva (obliquus) .·.··. nia.
rank = renken (Diez).

rang = aaa. rang raa. ι verbo ringan = nid. ringen (cenare),
unae: mugire, raugam arranger, deranger etc. ,

raoul κ mia. radulphus = nia rudolph (n. pa).

riaper = aia. rasphn = uia. raapeln i. e. reiben‚ unae: rape.

rapiere = aha. hrasp = naa. raspel?

rat: aaa rato = nia. rattr.

rate (splen) = hrt. ling. rate (Friseh). , ’

rayon (placenta mellita) = afrg. ree = mhd. rhz (plac.
mell.; cans. Grimm Gramm. III. 464).

rechin = dial. pic. rbche -τ- germ. hag. reSChe = rssflsshe
(asper, durus) (Diez)‚ unae: rechignement‚ reahigner.

redingote = angi. riding-eoat == nia. reitrock.

regalar = raa regulare = goti. gailjan (laetificare) (Diez).

regnauit = aia reginwald = reinhald (n. aa).

rem part = aas. rampar ε hal. ramparo = aar. ramme ss·
nia. ramme sive rampe (rum syn. sua „arr = rampart).

renard = aaa reginhart ε nar. reinhart.

renge urg. = mm, pinca = ahdahringa (Uncus, hamus)

’ (Diez). , ·

renna = rad. rann-(thiar) = ranner.

ribaud = rai ribaldo ε·- md. hripa (prostituta) = mir.
riba (homo perditus) :nia riepel (conr. aram ragimbald.
Grimm Gr. Ι. 444), urae: ribler‚ ribleur‚ ribaudoquin.

richard = ahd. rihhart. '

riche = aad. rihhi sive ricco = rik = aaa. reich, uuae: ri· -
chement, richesae.

ridet: aba. ridan (aphorisma), unde: ride, rideam·

riffler = aaa. rifihin (serra secare, serrare) = rna. nora.
rifa = nia riffeln = reiben.·

rime = raa a aaa rima = aaa. rim (serias numeras) a verbo
riman = nia reim, unae: rimaille‚ rimaillea rimailieur,
rimer, rimeua ’

6

 

